R 500 500
NO ./texture/wall_1.xpm
SO ./texture/wall_2.xpm
WE ./texture/wall_3.xpm
EA ./texture/wall_4.xpm

S ./texture/pillar.xpm
F 220,100,0
C 225,30,0

        1111111111111111111111111
        1000000000000000000000021
        1200000000000001111111111
       11100020000000000E1
11111111000000000000000111
10000000000000000000000011111
11111111111111110000000000001
10000000000000010000000000001
10000111111111110000000000001
10200000000000000000000000001
10000000000000011111100000001
1001111111000001    100000011
10000021 1000001    100000001
11111111 1111111    111111111