R 500 1080
NO ./images/NO.xpm
SO ./images/SO.xpm
WE ./images/WE.xpm
EA ./images/EA.xpm
S ./images/ITEM.xpm
F 255,0,0
C 255,255,255

        1111111111111111111111111
        10000000000000000000000011
        11000000000000000000000011
        10000000000000000000000011
1111111110000000000000000000000011
1000000000000000000000000000011111
10000000000000N100000000000011
10000000000000000000000002001
10000000000000000000000002001
10000000000000000000000002001
10000000000000000001010000001
11000001110101011111011110101
11110111 1110101 101111010001
11111111 1111111 111111111111